#####.##############
#..##..##########..#
##....#####...##..#.
##.##...###.#....##.
##..###..###.#.##.#.
###..###.##.#..####.
####..###.###.###..#
#.##.###.##...##.###
#.......##..#....###
#######...####.#####
#######.#..###.#####
###.#....#..#.##...#
#...######.##...####
#.###.####..####..##
#..##.#####.########
##................##
##.######.#####.##.#
###.#.#.####.....###
###..#.#.....###....
###################0