00000100000000000000
01100110000000000110
00111100000111001101
00100111000101111001
00110001100010100101
00011000100101100001
00001100010001000110
01001000100111001000
01111111001101111000
00000001110000100000
00000001011000100000
00010111101101001110
01110000001001110000
01000100001100001100
01100100000100000000
00111111111111111100
00100000010000010010
00010101000011111000
00011010111110001111
00000000000000000001