# # # # # . # # # # # # # # # # # # # #
# . . # # . . # # # # # # # # # # . . #
# # . . . . # # # # # . . . # # . . # .
# # . # # . . . # # # . # . . . . # # .
# # . . # # # . . # # # . # . # # . # .
# # # . . # # # . # # . # . . # # # # .
# # # # . . # # # . # # # . # # # . . #
# . # # . # # # . # # . . . # # . # # #
# . . . . . . . # # . . # . . . . # # #
# # # # # # # . . . # # # # . # # # # #
# # # # # # # . # . . # # # . # # # # #
# # # . # . . . . # . . # . # # . . . #
# . . . # # # # # # . # # . . . # # # #
# . # # # . # # # # . . # # # # . . # #
# . . # # . # # # # # . # # # # # # # #
# # . . . . . . . . . . . . . . . . # #
# # . # # # # # # . # # # # # . # # . #
# # # . # . # . # # # # . . . . . # # #
# # # . . # . # . . . . . # # # . . . .
# # # # # # # # # # # # # # # # # # # 0